[
    { "x": 1, "y": 1 },
    { "x": 1, "y": 2 },
    { "x": 2, "y": 3 },

    { "x": 7, "y": 1 },
    { "x": 6, "y": 1 },
    { "x": 8, "y": 2 },
    
    { "x": 4, "y": 4 },

    { "x": 1, "y": 8 },
    { "x": 2, "y": 6 },

    { "x": 8, "y": 1 }

]